C 36,43,75
F 01,10,255



1111111111111
1000000000001
1000000000001                                                                                   
1000000000001
1000000000001
1000N00000111
1000000000001
1000000000001
1000000000001
1000000000001
1000000000001
1000000000001
1111111111111