1111111111111111111111111
1P00C00C00C010C01C00C00C1
1111011101000000C00000001
1C00C1C1C111C11111C0000X1
1000010100000000011111111
1C00C1C00C00100C00C00C0E1
1111111111111111111111111