EA ./path_to_the_east_texture
NO ./path_to_the_north_texture
SO ./path_to_the_south_texture
WE ./path_to_the_west_texture

F 220,100,0
C 225,30,0

11111111111111111
10000000000000001
10000001110000001
10010000000001001
10010000S00001001
10000001110000001
10000000000000001
11111111111111111