EA ./path_to_the_east_texture
NO ./path_to_the_north_texture

SO ./path_to_the_south_texture
WE ./path_to_the_west_texture

F 75,139,59
C 135,206,235

11111111111111111111111111
10000000000000000000000001
10000000000000000000000001
10100000000000S00000000101
10000000000000000000000001
10001000000000100000010001
10000000000000000000000001
11111111111111111111111111