EA ./Textures/E.png
NO ./Textures/N.png

SO ./Textures/S.png


WE ./Textures/W.png

C 36,43,75
F 125,10,10

        1111111111111111111111111
        1000000000110000000000001
        1011000001110000000000001
        1001000000000000000000001
111111111011000001110000000000001
100000000011000001110111111111111
11110111111111011100000010001
11110111111111011101010000001
11000000110101011100000000001
10000000000000001100010000001
10000000000000001100000000001
11000001110101011111000000N0111
11110111 1110101 101111010001
11111111 1111111 111111111111