EA ./path_to_the_east_texture
NO ./path_to_the_north_texture

SO ./path_to_the_south_texture
WE ./path_to_the_west_texture

F 75,139,59
C 135,206,235

1111111111
1000000001
1000000001
10000S0001
1000000001
1111111111