EA ./path_to_the_east_texture
NO ./path_to_the_north_texture

SO ./path_to_the_south_texture
WE ./path_to_the_west_texture

F 220,100,0
C 225,30,0

111111111111111111111111111111
100000000000000000000000000001
100000000000001000000000000001
100010000000000000000000010001
100100000000000000000000001001
100000000000000000000000000001
10100000000000S000000000000101
100000000000000000000000000001
100000000000000000000000000001
100000000000000000000000000001
100100000000000000000000001001
100010000000001000000000010001
100000000000000000000000000001
100000011100000111000000000001
10000001 1000001 1000000000001
11111111 1111111 1111111111111