EA ./Textures/ki.png
NO ./Textures/N(1).png

SO ./Textures/S(1).png
WE ./Textures/he.png

C 36,43,75
F 125,10,10

1111111111111111111111111
1000000000000000000000001
10000000000N0000000000001
1000000000000000000000001
1111111111111111111111111